0 0 0 0 0 0 0 0 0 0 0 0 0 0 0 0 
0 0 0 0 0 0 0 0 0 0 0 0 0 0 0 0 
0 0 1 0 0 0 0 0 0 0 0 0 0 33 0 0 
0 0 14 0 0 0 0 0 0 0 0 0 0 32 0 0 
0 0 13 0 0 0 0 0 0 0 0 0 0 31 0 0 
0 0 2 0 0 0 0 0 0 0 0 0 0 30 0 0 
0 0 3 0 0 0 0 0 0 0 0 0 0 29 0 0 
0 0 4 6 7 17 20 21 22 23 6 7 17 28 0 0 
0 0 5 8 9 16 19 34 34 24 8 9 16 27 0 0 
0 0 12 11 10 15 18 34 34 25 11 10 15 26 0 0 
0 0 0 0 0 0 0 34 34 0 0 0 0 0 0 0 
0 0 0 0 0 0 0 34 34 0 0 0 0 0 0 0 