45 35 35 34 35 34 35 35 35 33 35 33 35 33 35 43 
24 46 2 4 2 4 2 36 1 3 1 3 1 3 44 32
22 19 0 0 0 0 0 0 0 0 0 0 0 0 27 30
24 21 0 0 0 0 0 0 0 0 0 0 0 0 29 32
22 19 0 0 0 0 0 0 0 0 0 11 0 0 27 30
24 38 0 0 11 0 0 0 0 0 0 0 0 0 37 32
24 38 0 0 0 0 0 0 0 0 0 0 0 0 37 32
23 18 0 0 0 0 0 0 0 0 0 0 0 0 26 31
24 20 0 0 0 0 0 0 0 0 0 0 0 0 28 32
23 18 0 0 0 0 0 0 0 0 0 0 0 0 26 31
24 42 9 15 9 15 9 13 12 8 14 8 14 8 40 32
41 17 25 17 25 17 7 10 10 6 16 25 16 25 16 39